NO ./textures_psy/NO_hypno_spiral.xpm
SO ./textures_psy/SO_kaleido_plasma.xpm
WE ./textures_psy/WE_warped_checker.xpm
EA ./textures_psy/EA_chromatic_bloom.xpm

F 0,100,200
C                 225,30,0
         


           

        1111111111111111111111111111
        1000000000110000000000001101
        1011000001110000000000001111
        1001000000000000000000001
111111111011000001110000000000001
100000000011000001110111111111111
11110111111111011100000010001
1111011111111011101010010001
11000000110101011100000010001
10000000000000001100000010001
100000000S0000001101010010001
110000011101010111110111100111
11110111 1110101 101111010001
11111111 1111111 111111111111